year,country,Bronze,Silver,Gold,total,athlete_count
1896,Australia,1,0,2,3,1
1896,Austria,2,1,2,5,3
1896,Denmark,3,2,1,6,4
1896,France,2,4,5,11,13
1896,Germany,2,5,25,32,19
1896,Greece,21,21,10,52,102
1896,Hungary,3,1,2,6,7
1896,Switzerland,0,2,1,3,2
1896,UK,3,3,3,9,11
1896,USA,2,7,11,20,15
1900,Australia,3,0,1,4,1
1900,Austria,3,3,0,6,15
1900,Belgium,16,23,6,45,66
1900,Cuba,0,1,1,2,1
1900,Czech Republic,2,1,0,3,7
1900,Denmark,2,3,4,9,13
1900,France,86,110,57,253,748
1900,Germany,11,20,14,45,77
1900,Hungary,2,2,1,5,18
1900,India,0,2,0,2,1
1900,Italy,0,2,3,5,23
1900,Mexico,3,0,0,3,3
1900,Netherlands,15,8,3,26,35
1900,Norway,3,6,0,9,7
1900,Spain,0,0,2,2,9
1900,Sweden,1,0,3,4,10
1900,Switzerland,1,5,16,22,19
1900,UK,11,27,62,100,97
1900,USA,17,14,28,59,72
1904,Canada,12,9,27,48,57
1904,Cuba,0,0,5,5,3
1904,Germany,5,4,5,14,20
1904,Greece,1,0,1,2,14
1904,Hungary,1,1,2,4,4
1904,UK,0,1,1,2,4
1904,USA,131,148,132,411,555
1908,Australia,2,2,15,19,30
1908,Austria,1,0,0,1,14
1908,Belgium,8,24,1,33,72
1908,Canada,29,8,14,51,86
1908,Czech Republic,6,0,0,6,23
1908,Denmark,3,14,0,17,79
1908,Finland,28,1,1,30,62
1908,France,23,5,12,40,222
1908,Germany,6,11,4,21,92
1908,Greece,1,3,0,4,20
1908,Hungary,5,7,7,19,81
1908,Italy,0,6,2,8,68
1908,Netherlands,16,0,0,16,115
1908,Norway,3,32,7,42,69
1908,Russia,0,2,1,3,6
1908,South Africa,0,1,1,2,15
1908,Sweden,18,18,48,84,173
1908,UK,90,131,147,368,751
1908,USA,15,16,34,65,128
1912,Australia,3,2,5,10,25
1912,Austria,5,9,0,14,86
1912,Belgium,11,1,7,19,37
1912,Canada,3,2,3,8,37
1912,Denmark,33,49,5,87,154
1912,Finland,22,40,9,71,164
1912,France,5,10,10,25,127
1912,Germany,23,19,10,52,184
1912,Greece,1,0,1,2,28
1912,Hungary,3,17,10,30,130
1912,Italy,2,1,20,23,68
1912,Netherlands,26,0,0,26,35
1912,Norway,34,7,39,80,193
1912,Russia,9,5,0,14,158
1912,South Africa,0,2,5,7,21
1912,Sweden,25,63,102,190,447
1912,UK,59,64,47,170,280
1912,USA,36,25,46,107,178
1920,Australia,1,5,0,6,13
1920,Belgium,62,64,55,181,333
1920,Brazil,5,1,1,7,19
1920,Canada,3,3,10,16,55
1920,Czech Republic,10,0,0,10,121
1920,Denmark,1,44,26,71,157
1920,Estonia,0,2,1,3,14
1920,Finland,17,14,21,52,62
1920,France,57,69,13,139,305
1920,Greece,0,5,0,5,47
1920,Italy,8,8,66,82,176
1920,Japan,0,3,0,3,15
1920,Luxembourg,0,1,0,1,25
1920,Netherlands,25,10,15,50,133
1920,New Zealand,1,0,0,1,4
1920,Norway,27,52,58,137,193
1920,South Africa,6,12,3,21,39
1920,Spain,0,23,0,23,57
1920,Sweden,64,38,52,154,261
1920,Switzerland,21,2,6,29,79
1920,UK,17,40,53,110,234
1920,USA,38,45,111,194,289
1924,Argentina,2,3,5,10,78
1924,Australia,2,4,3,9,35
1924,Austria,1,4,3,8,57
1924,Belgium,11,30,3,44,197
1924,Canada,1,19,9,29,78
1924,Czech Republic,5,4,1,10,177
1924,Denmark,2,8,2,12,79
1924,Estonia,4,1,1,6,39
1924,Finland,18,21,28,67,138
1924,France,30,51,36,117,376
1924,Haiti,5,0,0,5,8
1924,Hungary,8,12,2,22,102
1924,Italy,21,5,27,53,228
1924,Japan,1,0,0,1,19
1924,Netherlands,17,1,8,26,155
1924,New Zealand,1,0,0,1,4
1924,Norway,9,12,18,39,75
1924,Poland,1,4,0,5,75
1924,Portugal,4,0,0,4,28
1924,Romania,16,0,0,16,35
1924,Serbia,0,0,2,2,45
1924,South Africa,1,1,1,3,29
1924,Sweden,41,30,8,79,200
1924,Switzerland,22,25,22,69,164
1924,UK,30,33,19,82,296
1924,USA,50,46,97,193,324
1924,Uruguay,0,0,14,14,25
1928,Argentina,5,18,3,26,93
1928,Australia,1,2,1,4,18
1928,Austria,4,4,2,10,90
1928,Belgium,5,1,0,6,202
1928,Canada,21,5,19,45,92
1928,Chile,0,1,0,1,39
1928,Czech Republic,3,12,2,17,99
1928,Denmark,2,4,6,12,81
1928,Egypt,1,1,2,4,32
1928,Estonia,6,1,2,9,22
1928,Finland,10,9,10,29,93
1928,France,13,22,13,48,287
1928,Germany,41,13,20,74,260
1928,Haiti,0,1,0,1,2
1928,Hungary,0,11,9,20,124
1928,India,0,0,14,14,21
1928,Ireland,0,0,1,1,30
1928,Italy,26,21,24,71,181
1928,Japan,1,5,2,8,46
1928,Netherlands,6,28,18,52,227
1928,New Zealand,0,0,1,1,10
1928,Norway,6,8,10,24,79
1928,Philippines,1,0,0,1,4
1928,Poland,14,3,1,18,90
1928,Portugal,6,0,0,6,32
1928,Serbia,10,1,1,12,46
1928,South Africa,5,0,1,6,25
1928,Spain,0,0,3,3,81
1928,Sweden,23,21,9,53,126
1928,Switzerland,16,8,16,40,160
1928,UK,25,26,6,57,228
1928,USA,19,30,49,98,259
1928,Uruguay,0,0,17,17,17
1932,Argentina,0,1,3,4,34
1932,Australia,1,1,3,5,12
1932,Austria,3,2,2,7,17
1932,Canada,28,14,16,58,149
1932,Czech Republic,1,2,1,4,14
1932,Denmark,4,5,0,9,24
1932,Finland,17,9,6,32,48
1932,France,6,8,25,39,73
1932,Germany,19,26,7,52,107
1932,Hungary,10,5,20,35,54
1932,India,0,0,15,15,19
1932,Ireland,0,0,2,2,8
1932,Italy,18,38,21,77,114
1932,Japan,4,17,10,31,134
1932,Latvia,0,1,0,1,2
1932,Mexico,0,2,0,2,72
1932,Netherlands,0,10,2,12,24
1932,New Zealand,0,2,0,2,21
1932,Norway,3,4,3,10,26
1932,Philippines,3,0,0,3,8
1932,Poland,14,3,2,19,35
1932,South Africa,3,0,2,5,12
1932,Spain,1,0,0,1,6
1932,Sweden,12,9,13,34,64
1932,Switzerland,0,3,0,3,14
1932,UK,14,12,8,34,77
1932,USA,64,63,88,215,357
1932,Uruguay,1,0,0,1,1
1936,Argentina,4,2,5,11,51
1936,Australia,1,0,0,1,33
1936,Austria,6,43,6,55,233
1936,Belgium,13,0,0,13,149
1936,Canada,9,25,1,35,127
1936,Czech Republic,0,12,5,17,211
1936,Denmark,3,3,0,6,118
1936,Egypt,2,1,2,5,53
1936,Estonia,3,2,2,7,38
1936,Finland,16,8,11,35,126
1936,France,19,13,13,45,235
1936,Germany,58,66,91,215,404
1936,Hungary,17,1,25,43,235
1936,India,0,0,19,19,28
1936,Italy,5,30,36,71,223
1936,Japan,8,4,9,21,185
1936,Latvia,1,1,0,2,50
1936,Mexico,16,0,0,16,32
1936,Netherlands,21,7,9,37,137
1936,New Zealand,0,0,1,1,7
1936,Norway,18,20,8,46,100
1936,Philippines,1,0,0,1,28
1936,Poland,4,5,0,9,134
1936,Portugal,3,0,0,3,19
1936,Romania,0,1,0,1,67
1936,Serbia,0,1,0,1,108
1936,South Africa,0,1,0,1,25
1936,Sweden,22,13,9,44,184
1936,Switzerland,24,29,5,58,213
1936,Turkey,1,0,1,2,55
1936,UK,12,17,25,54,245
1936,USA,29,26,53,108,366
1948,Argentina,1,8,3,12,212
1948,Australia,5,9,2,16,75
1948,Austria,7,3,2,12,173
1948,Belgium,8,6,7,21,164
1948,Brazil,10,0,0,10,70
1948,Canada,7,1,13,21,133
1948,Cuba,0,2,0,2,53
1948,Czech Republic,3,20,14,37,125
1948,Denmark,26,15,7,48,163
1948,Egypt,1,2,2,5,88
1948,Finland,10,13,16,39,148
1948,France,24,23,27,74,323
1948,Hungary,21,27,15,63,156
1948,India,0,0,20,20,77
1948,Iran,1,0,0,1,36
1948,Italy,12,31,21,64,239
1948,Jamaica,0,2,1,3,14
1948,Mexico,4,1,4,9,89
1948,Netherlands,32,2,8,42,147
1948,Norway,17,7,7,31,129
1948,Panama,2,0,0,2,1
1948,Peru,0,0,1,1,41
1948,Poland,1,0,0,1,52
1948,Portugal,3,2,0,5,49
1948,Puerto Rico,1,0,0,1,9
1948,Serbia,0,16,0,16,104
1948,South Africa,1,1,2,4,32
1948,South Korea,2,0,0,2,49
1948,Spain,0,3,0,3,70
1948,Sri Lanka,0,1,0,1,7
1948,Sweden,32,18,36,86,220
1948,Switzerland,24,27,9,60,243
1948,Trinidad,0,1,0,1,5
1948,Turkey,2,4,6,12,63
1948,UK,13,40,6,59,375
1948,USA,41,34,89,164,372
1948,Uruguay,2,1,0,3,61
1952,Argentina,2,2,2,6,137
1952,Australia,11,2,7,20,92
1952,Austria,4,5,2,11,151
1952,Belgium,0,3,5,8,145
1952,Brazil,2,0,1,3,99
1952,Bulgaria,1,0,0,1,73
1952,Canada,1,3,17,21,146
1952,Chile,0,4,0,4,63
1952,Czech Republic,10,4,11,25,122
1952,Denmark,5,1,3,9,132
1952,Egypt,1,0,0,1,106
1952,Finland,31,7,14,52,309
1952,France,18,9,14,41,273
1952,Germany,28,16,8,52,297
1952,Hungary,34,17,52,103,202
1952,India,1,0,14,15,68
1952,Iran,4,3,0,7,22
1952,Ireland,0,1,0,1,21
1952,Italy,16,22,18,56,264
1952,Jamaica,0,3,5,8,8
1952,Japan,2,9,1,12,82
1952,Luxembourg,0,0,1,1,44
1952,Mexico,0,1,0,1,64
1952,Netherlands,0,21,0,21,116
1952,New Zealand,2,0,1,3,17
1952,Norway,6,14,12,32,173
1952,Poland,1,2,1,4,158
1952,Portugal,2,0,0,2,73
1952,Romania,2,1,1,4,130
1952,Russia,19,62,36,117,297
1952,Serbia,0,20,4,24,96
1952,South Africa,4,8,2,14,65
1952,South Korea,2,0,0,2,19
1952,Spain,0,1,0,1,33
1952,Sweden,45,24,23,92,272
1952,Switzerland,18,19,2,39,213
1952,Trinidad,2,0,0,2,2
1952,Turkey,1,0,2,3,51
1952,UK,26,2,4,32,276
1952,USA,29,48,83,160,355
1952,Uruguay,14,0,0,14,32
1952,Venezuela,1,0,0,1,38
1956,Argentina,1,1,0,2,28
1956,Australia,26,12,23,61,308
1956,Austria,8,3,5,16,89
1956,Bahamas,2,0,0,2,4
1956,Belgium,0,2,0,2,59
1956,Brazil,0,0,1,1,44
1956,Bulgaria,14,3,1,18,51
1956,Canada,20,11,5,36,127
1956,Chile,2,2,0,4,36
1956,Czech Republic,1,5,1,7,104
1956,Denmark,1,3,1,5,31
1956,Finland,23,7,8,38,95
1956,France,13,13,7,33,171
1956,Germany,23,13,6,42,223
1956,Greece,1,0,0,1,16
1956,Hungary,16,20,30,66,111
1956,Iceland,0,1,0,1,9
1956,India,0,0,17,17,59
1956,Iran,1,2,2,5,20
1956,Ireland,3,1,1,5,12
1956,Italy,9,13,28,50,196
1956,Japan,5,16,4,25,121
1956,Mexico,1,0,1,2,24
1956,New Zealand,0,0,3,3,51
1956,Norway,3,1,3,7,64
1956,Pakistan,0,14,0,14,58
1956,Poland,10,9,1,20,115
1956,Romania,10,3,6,19,64
1956,Russia,61,51,94,206,326
1956,Serbia,0,23,0,23,55
1956,South Africa,7,0,0,7,50
1956,South Korea,1,1,0,2,39
1956,Sweden,15,18,11,44,148
1956,Switzerland,2,2,6,10,65
1956,Turkey,2,2,3,7,17
1956,UK,18,16,5,39,232
1956,USA,25,56,63,144,364
1956,Uruguay,12,0,0,12,21
1960,Argentina,1,3,0,4,98
1960,Australia,9,17,11,37,219
1960,Austria,3,4,2,9,132
1960,Belgium,2,2,0,4,103
1960,Brazil,13,0,0,13,71
1960,Bulgaria,3,3,1,7,106
1960,Canada,1,26,3,30,129
1960,Czech Republic,11,8,4,23,137
1960,Denmark,4,17,2,23,102
1960,Ethiopia,0,0,1,1,11
1960,Finland,9,4,6,19,165
1960,France,8,6,1,15,266
1960,Germany,23,37,38,98,373
1960,Ghana,0,1,0,1,15
1960,Greece,0,0,3,3,48
1960,Hungary,37,16,13,66,191
1960,India,0,13,0,13,51
1960,Iran,3,1,0,4,23
1960,Iraq,1,0,0,1,21
1960,Italy,35,18,36,89,311
1960,Japan,10,10,9,29,205
1960,Mexico,1,0,0,1,69
1960,Morocco,0,1,0,1,47
1960,Netherlands,3,2,0,5,119
1960,New Zealand,1,0,2,3,41
1960,Norway,0,6,5,11,69
1960,Pakistan,1,0,13,14,47
1960,Poland,16,12,4,32,209
1960,Portugal,0,2,0,2,65
1960,Romania,11,1,3,15,103
1960,Russia,73,70,68,211,346
1960,Serbia,0,1,16,17,117
1960,South Africa,2,1,0,3,60
1960,Spain,14,0,0,14,148
1960,Sweden,5,4,7,16,184
1960,Switzerland,6,6,2,14,170
1960,Syria,1,1,0,2,75
1960,Taiwan,0,1,0,1,27
1960,Trinidad,5,0,0,5,14
1960,Turkey,0,2,7,9,51
1960,UK,15,11,2,28,274
1960,USA,25,27,87,139,371
1960,Venezuela,1,0,0,1,36
1964,Argentina,0,1,0,1,114
1964,Australia,29,5,8,42,250
1964,Austria,3,9,5,17,139
1964,Bahamas,0,0,2,2,11
1964,Belgium,1,0,2,3,68
1964,Brazil,12,0,0,12,61
1964,Bulgaria,2,5,3,10,72
1964,Canada,2,4,6,12,170
1964,Cuba,0,1,0,1,27
1964,Czech Republic,29,37,5,71,150
1964,Denmark,4,1,7,12,62
1964,Ethiopia,0,0,1,1,12
1964,Finland,7,7,6,20,141
1964,France,17,17,4,38,163
1964,Germany,53,48,25,126,437
1964,Ghana,1,0,0,1,33
1964,Hungary,7,7,42,56,212
1964,India,0,0,15,15,56
1964,Iran,2,0,0,2,66
1964,Ireland,1,0,0,1,25
1964,Italy,17,30,14,61,230
1964,Japan,24,5,32,61,383
1964,Kenya,1,0,0,1,38
1964,Mexico,1,0,0,1,94
1964,Netherlands,16,10,6,32,131
1964,New Zealand,2,0,4,6,65
1964,Nigeria,1,0,0,1,18
1964,North Korea,0,1,0,1,14
1964,Norway,6,6,3,15,84
1964,Pakistan,0,16,0,16,41
1964,Philippines,0,1,0,1,47
1964,Poland,23,13,10,46,192
1964,Romania,10,4,2,16,166
1964,Russia,59,71,90,220,387
1964,Serbia,2,11,2,15,106
1964,South Korea,1,2,0,3,161
1964,Sweden,9,25,9,43,154
1964,Switzerland,1,4,1,6,139
1964,Trinidad,5,1,0,6,13
1964,Tunisia,1,1,0,2,9
1964,Turkey,1,3,2,6,28
1964,UK,5,19,6,30,242
1964,USA,42,39,79,160,436
1964,Uruguay,1,0,0,1,23
1968,Argentina,2,0,0,2,95
1968,Australia,11,34,5,50,132
1968,Austria,7,10,3,20,119
1968,Belgium,2,1,0,3,83
1968,Brazil,3,1,0,4,77
1968,Bulgaria,3,21,2,26,118
1968,Cameroon,0,1,0,1,5
1968,Canada,22,4,4,30,208
1968,Cuba,0,10,0,10,115
1968,Czech Republic,16,26,8,50,169
1968,Denmark,6,6,5,17,67
1968,Ethiopia,0,1,1,2,19
1968,Finland,6,4,2,12,118
1968,France,12,8,16,36,277
1968,Germany,44,40,34,118,651
1968,Greece,1,0,0,1,48
1968,Hungary,29,20,32,81,181
1968,India,16,0,0,16,28
1968,Iran,2,1,2,5,18
1968,Italy,20,8,13,41,221
1968,Jamaica,0,1,0,1,26
1968,Japan,22,25,16,63,236
1968,Kenya,2,7,3,12,39
1968,Mexico,3,3,3,9,275
1968,Mongolia,3,1,0,4,23
1968,Netherlands,4,10,9,23,117
1968,New Zealand,2,0,5,7,59
1968,Norway,2,11,15,28,111
1968,Pakistan,0,0,13,13,16
1968,Poland,30,2,5,37,208
1968,Romania,11,9,5,25,112
1968,Russia,65,68,91,224,389
1968,Serbia,2,14,13,29,99
1968,South Korea,1,1,0,2,63
1968,Sweden,7,11,7,25,169
1968,Switzerland,17,5,0,22,119
1968,Taiwan,1,0,0,1,43
1968,Tunisia,1,0,1,2,7
1968,Turkey,0,0,2,2,40
1968,UK,5,5,9,19,266
1968,USA,36,37,84,157,455
1968,Uganda,1,1,0,2,11
1968,Venezuela,0,0,1,1,26
1972,Argentina,0,1,0,1,95
1972,Australia,2,7,11,20,173
1972,Austria,4,3,1,8,151
1972,Belgium,0,2,0,2,90
1972,Brazil,2,0,0,2,82
1972,Bulgaria,6,10,6,22,135
1972,Canada,8,3,0,11,256
1972,Colombia,2,1,0,3,59
1972,Cuba,18,1,3,22,137
1972,Czech Republic,25,21,3,49,223
1972,Denmark,0,0,1,1,126
1972,Ethiopia,2,0,0,2,32
1972,Finland,7,10,3,20,147
1972,France,17,6,2,25,273
1972,Germany,108,84,83,275,844
1972,Ghana,1,0,0,1,35
1972,Greece,0,2,0,2,63
1972,Hungary,25,46,10,81,236
1972,India,14,0,0,14,44
1972,Iran,1,2,0,3,52
1972,Italy,14,8,12,34,270
1972,Jamaica,1,0,0,1,35
1972,Japan,9,20,30,59,269
1972,Kenya,4,3,5,12,57
1972,Mexico,0,1,0,1,175
1972,Mongolia,0,1,0,1,43
1972,Netherlands,4,4,7,15,131
1972,New Zealand,1,4,9,14,93
1972,Niger,1,0,0,1,4
1972,Nigeria,1,0,0,1,25
1972,North Korea,13,1,1,15,43
1972,Norway,11,10,4,25,182
1972,Pakistan,0,15,0,15,26
1972,Poland,11,8,28,47,337
1972,Romania,27,10,3,40,173
1972,Russia,61,52,143,256,448
1972,Serbia,2,1,15,18,153
1972,South Korea,0,1,0,1,49
1972,Spain,1,0,1,2,126
1972,Sweden,10,11,5,26,190
1972,Switzerland,7,11,7,25,203
1972,Tunisia,0,1,0,1,35
1972,Turkey,0,1,0,1,44
1972,UK,12,9,8,29,323
1972,USA,46,76,56,178,507
1972,Uganda,0,1,1,2,33
1976,Australia,8,15,0,23,188
1976,Austria,4,2,2,8,140
1976,Belgium,6,3,0,9,106
1976,Bermuda,1,0,0,1,17
1976,Brazil,3,0,0,3,80
1976,Bulgaria,18,13,8,39,187
1976,Canada,13,9,1,23,444
1976,Cuba,14,4,6,24,162
1976,Czech Republic,9,23,2,34,221
1976,Denmark,5,0,3,8,67
1976,Finland,1,12,9,22,130
1976,France,9,7,5,21,244
1976,Germany,109,89,134,332,691
1976,Hungary,35,6,14,55,183
1976,Iran,1,1,0,2,90
1976,Italy,5,27,3,35,272
1976,Jamaica,0,1,1,2,20
1976,Japan,10,6,25,41,271
1976,Liechtenstein,2,0,0,2,15
1976,Mexico,1,0,1,2,97
1976,Mongolia,0,1,0,1,32
1976,Netherlands,15,4,1,20,115
1976,New Zealand,9,1,15,25,85
1976,North Korea,0,1,1,2,38
1976,Norway,1,10,5,16,108
1976,Pakistan,16,0,0,16,24
1976,Poland,26,29,18,73,271
1976,Portugal,0,2,0,2,19
1976,Puerto Rico,1,0,0,1,80
1976,Romania,23,28,4,55,189
1976,Russia,88,100,152,340,489
1976,Serbia,3,14,2,19,116
1976,South Korea,15,1,1,17,53
1976,Spain,0,6,0,6,118
1976,Sweden,2,1,9,12,157
1976,Switzerland,8,9,2,19,109
1976,Thailand,1,0,0,1,42
1976,Trinidad,0,0,1,1,13
1976,UK,11,15,7,33,286
1976,USA,41,59,66,166,504
1976,Venezuela,0,1,0,1,33
1980,Australia,5,2,5,12,129
1980,Austria,4,5,4,13,126
1980,Belgium,0,0,1,1,62
1980,Brazil,5,0,4,9,106
1980,Bulgaria,39,44,8,91,280
1980,Canada,1,1,0,2,59
1980,Cuba,5,7,8,20,209
1980,Czech Republic,17,18,17,52,250
1980,Denmark,2,2,4,8,58
1980,Ethiopia,2,0,2,4,41
1980,Finland,11,6,4,21,160
1980,France,7,5,18,30,145
1980,Germany,79,100,129,308,481
1980,Greece,4,0,1,5,44
1980,Guyana,1,0,0,1,8
1980,Hungary,40,15,8,63,266
1980,India,0,0,16,16,72
1980,Ireland,1,2,0,3,47
1980,Italy,8,24,8,40,206
1980,Jamaica,3,0,0,3,21
1980,Japan,0,1,0,1,50
1980,Liechtenstein,0,2,2,4,7
1980,Mexico,9,1,0,10,45
1980,Mongolia,2,2,0,4,46
1980,Netherlands,6,3,1,10,104
1980,North Korea,2,3,0,5,47
1980,Norway,9,6,1,16,64
1980,Poland,22,25,3,50,337
1980,Romania,46,15,7,68,263
1980,Russia,131,154,199,484,575
1980,Serbia,17,27,13,57,179
1980,Spain,3,19,2,24,164
1980,Sweden,29,6,6,41,207
1980,Switzerland,3,4,4,11,117
1980,Tanzania,0,2,0,2,41
1980,UK,22,18,6,46,271
1980,USA,2,4,24,30,103
1980,Uganda,0,1,0,1,14
1980,Venezuela,0,1,0,1,37
1980,Zimbabwe,0,0,15,15,42
1984,Algeria,2,0,0,2,33
1984,Australia,31,14,7,52,256
1984,Austria,2,1,1,4,168
1984,Belgium,2,2,1,5,67
1984,Brazil,2,33,1,36,147
1984,Cameroon,1,0,0,1,46
1984,Canada,33,37,21,91,476
1984,China,37,13,24,74,301
1984,Colombia,0,1,0,1,39
1984,Czech Republic,4,24,0,28,50
1984,Denmark,10,3,0,13,62
1984,Dominican Republic,1,0,0,1,19
1984,Egypt,0,1,0,1,115
1984,Finland,18,5,8,31,132
1984,France,33,17,20,70,272
1984,Germany,64,89,46,199,532
1984,Greece,1,1,0,2,70
1984,Iceland,1,0,0,1,35
1984,Ireland,0,1,0,1,42
1984,Italy,28,6,31,65,351
1984,Ivory Coast,0,1,0,1,15
1984,Jamaica,2,5,0,7,47
1984,Japan,31,9,10,50,266
1984,Kenya,2,0,1,3,61
1984,Liechtenstein,2,0,0,2,17
1984,Mexico,1,3,2,6,102
1984,Morocco,0,0,2,2,38
1984,Netherlands,14,7,20,41,149
1984,New Zealand,6,1,16,23,136
1984,Nigeria,4,1,0,5,32
1984,Norway,7,6,6,19,161
1984,Pakistan,0,0,16,16,31
1984,Peru,0,1,0,1,36
1984,Portugal,2,0,1,3,38
1984,Puerto Rico,1,1,0,2,53
1984,Romania,35,31,40,106,143
1984,Russia,12,15,29,56,99
1984,Serbia,35,6,47,88,214
1984,South Korea,7,28,6,41,190
1984,Spain,3,14,2,19,192
1984,Sweden,34,20,10,64,236
1984,Switzerland,8,11,2,21,175
1984,Syria,0,1,0,1,9
1984,Taiwan,1,0,0,1,51
1984,Thailand,0,1,0,1,39
1984,Turkey,3,0,0,3,53
1984,UK,43,20,11,74,388
1984,USA,50,121,190,361,631
1984,Venezuela,3,0,0,3,26
1984,Zambia,1,0,0,1,16
1988,Argentina,12,1,0,13,133
1988,Australia,11,6,18,35,278
1988,Austria,4,5,4,13,155
1988,Belgium,2,0,0,2,61
1988,Brazil,5,17,1,23,161
1988,Bulgaria,17,14,10,41,199
1988,Canada,18,7,4,29,448
1988,Chile,0,1,0,1,22
1988,China,30,16,6,52,343
1988,Colombia,1,0,0,1,40
1988,Costa Rica,0,1,0,1,18
1988,Curacao,0,1,0,1,5
1988,Czech Republic,8,5,3,16,224
1988,Denmark,3,1,3,7,81
1988,Djibouti,1,0,0,1,6
1988,Finland,7,23,8,38,132
1988,France,14,4,13,31,343
1988,Germany,104,113,125,342,755
1988,Greece,1,0,0,1,63
1988,Hungary,15,9,20,44,195
1988,Indonesia,0,3,0,3,29
1988,Iran,0,1,0,1,23
1988,Italy,13,11,13,37,320
1988,Jamaica,0,5,0,5,39
1988,Japan,14,3,4,21,311
1988,Kenya,2,2,5,9,74
1988,Liechtenstein,1,0,0,1,25
1988,Mexico,2,0,0,2,94
1988,Mongolia,1,0,0,1,31
1988,Morocco,2,0,1,3,30
1988,Netherlands,38,8,6,52,170
1988,New Zealand,16,4,4,24,91
1988,Norway,5,26,2,33,139
1988,Pakistan,1,0,0,1,30
1988,Peru,0,12,0,12,21
1988,Philippines,1,0,0,1,32
1988,Poland,10,9,2,21,176
1988,Portugal,0,0,1,1,70
1988,Romania,16,34,8,58,79
1988,Russia,111,81,174,366,584
1988,Senegal,0,1,0,1,23
1988,Serbia,22,32,15,69,178
1988,South Korea,12,37,28,77,436
1988,Spain,2,2,1,5,244
1988,Suriname,0,0,1,1,6
1988,Sweden,34,5,7,46,257
1988,Switzerland,7,13,8,28,174
1988,Thailand,1,0,0,1,14
1988,Turkey,0,1,1,2,49
1988,UK,15,16,22,53,401
1988,USA,58,67,89,214,658
1988,"Virgin Islands, US",0,1,0,1,27
1992,Algeria,1,0,1,2,40
1992,Argentina,2,0,0,2,104
1992,Australia,16,27,14,57,305
1992,Austria,10,16,9,35,162
1992,Bahamas,1,0,0,1,14
1992,Belgium,2,1,0,3,74
1992,Brazil,0,1,13,14,189
1992,Bulgaria,7,7,3,17,168
1992,Canada,15,33,32,80,408
1992,China,19,48,18,85,314
1992,Colombia,1,0,0,1,49
1992,Croatia,3,12,0,15,43
1992,Cuba,14,13,42,69,178
1992,Czech Republic,28,3,4,35,283
1992,Denmark,9,2,3,14,122
1992,Estonia,2,0,1,3,56
1992,Ethiopia,2,0,1,3,20
1992,Finland,8,5,7,20,150
1992,France,44,11,14,69,451
1992,Germany,67,74,95,236,579
1992,Ghana,20,0,0,20,34
1992,Greece,0,0,2,2,79
1992,Hungary,8,23,14,45,242
1992,Individual Olympic Athletes,2,1,0,3,58
1992,Indonesia,1,3,2,6,42
1992,Iran,2,1,0,3,36
1992,Ireland,0,1,1,2,61
1992,Israel,1,1,0,2,30
1992,Italy,22,19,25,66,415
1992,Jamaica,1,3,0,4,41
1992,Japan,43,10,6,59,317
1992,Kenya,2,4,2,8,49
1992,Latvia,1,2,0,3,57
1992,Lithuania,12,0,1,13,53
1992,Luxembourg,0,2,0,2,7
1992,Malaysia,2,0,0,2,26
1992,Mexico,0,1,0,1,122
1992,Mongolia,2,0,0,2,37
1992,Morocco,1,1,1,3,58
1992,Namibia,0,2,0,2,6
1992,Netherlands,10,21,6,37,223
1992,New Zealand,5,10,1,16,140
1992,Nigeria,4,7,0,11,55
1992,North Korea,7,0,4,11,84
1992,Norway,6,31,14,51,170
1992,Pakistan,16,0,0,16,27
1992,Peru,0,1,0,1,16
1992,Philippines,1,0,0,1,27
1992,Poland,19,22,5,46,254
1992,Puerto Rico,1,0,0,1,78
1992,Qatar,1,0,0,1,28
1992,Romania,14,31,8,53,196
1992,Russia,81,71,127,279,613
1992,Slovenia,6,0,0,6,62
1992,South Africa,0,3,0,3,93
1992,South Korea,17,6,33,56,252
1992,Spain,3,19,48,70,440
1992,Suriname,1,0,0,1,6
1992,Sweden,13,27,2,42,265
1992,Switzerland,5,0,3,8,180
1992,Taiwan,0,20,0,20,39
1992,Thailand,1,0,0,1,46
1992,Turkey,2,2,2,6,49
1992,UK,39,3,8,50,427
1992,USA,87,57,94,238,699
1994,Australia,4,0,0,4,26
1994,Austria,7,3,2,12,80
1994,Belarus,0,2,0,2,33
1994,Canada,5,29,3,37,96
1994,China,2,1,0,3,24
1994,Finland,29,1,0,30,61
1994,France,10,1,0,11,99
1994,Germany,12,10,18,40,112
1994,Italy,12,6,14,32,105
1994,Japan,2,5,3,10,59
1994,Kazakhstan,0,2,1,3,29
1994,Netherlands,3,1,0,4,21
1994,Norway,5,19,10,34,89
1994,Russia,4,13,19,36,115
1994,Slovenia,3,0,0,3,22
1994,South Korea,1,1,7,9,21
1994,Sweden,0,1,23,24,84
1994,Switzerland,4,8,4,16,59
1994,UK,3,0,0,3,32
1994,USA,5,8,6,19,147
1994,Ukraine,1,0,1,2,37
1994,Uzbekistan,0,0,1,1,7
1996,Algeria,1,0,2,3,46
1996,Argentina,1,19,0,20,179
1996,Armenia,0,1,1,2,32
1996,Australia,84,16,32,132,420
1996,Austria,2,1,0,3,73
1996,Azerbaijan,0,1,0,1,23
1996,Bahamas,0,5,0,5,27
1996,Belarus,16,6,1,23,157
1996,Belgium,2,2,2,6,61
1996,Brazil,43,15,5,63,223
1996,Bulgaria,6,12,3,21,110
1996,Burundi,0,0,1,1,7
1996,Canada,12,30,8,50,303
1996,China,17,70,20,107,319
1996,Costa Rica,0,0,1,1,11
1996,Croatia,0,12,16,28,84
1996,Cuba,10,8,37,55,167
1996,Czech Republic,4,5,4,13,115
1996,Denmark,1,1,21,23,120
1996,Ecuador,0,0,1,1,19
1996,Ethiopia,1,0,2,3,18
1996,Finland,1,2,1,4,76
1996,France,20,10,21,51,299
1996,Georgia,2,0,0,2,34
1996,Germany,47,35,42,124,469
1996,Greece,0,4,4,8,121
1996,Hungary,26,9,8,43,213
1996,India,1,0,0,1,49
1996,Indonesia,3,1,2,6,40
1996,Iran,1,1,1,3,18
1996,Ireland,1,0,3,4,78
1996,Israel,1,0,0,1,25
1996,Italy,28,24,19,71,340
1996,Jamaica,12,3,1,16,46
1996,Japan,13,26,3,42,306
1996,Kazakhstan,4,4,3,11,96
1996,Kenya,3,4,1,8,52
1996,Latvia,0,1,0,1,48
1996,Lithuania,11,0,0,11,61
1996,Malaysia,1,2,0,3,36
1996,Mexico,1,0,0,1,98
1996,Moldova,1,2,0,3,40
1996,Mongolia,1,0,0,1,16
1996,Morocco,2,0,0,2,34
1996,Mozambique,1,0,0,1,4
1996,Namibia,0,2,0,2,8
1996,Netherlands,26,9,38,73,239
1996,New Zealand,4,2,3,9,95
1996,Nigeria,3,4,17,24,66
1996,North Korea,2,1,2,5,24
1996,Norway,18,3,2,23,97
1996,Philippines,0,1,0,1,12
1996,Poland,7,8,7,22,165
1996,Portugal,2,0,1,3,107
1996,Puerto Rico,1,0,0,1,69
1996,Romania,15,10,13,38,165
1996,Russia,34,45,36,115,391
1996,Serbia,13,12,1,26,68
1996,Slovakia,1,1,1,3,71
1996,Slovenia,0,2,0,2,37
1996,South Africa,1,1,3,5,84
1996,South Korea,7,49,10,66,305
1996,Spain,22,21,23,66,291
1996,Sweden,5,23,3,31,178
1996,Switzerland,0,6,5,11,115
1996,Syria,0,0,1,1,7
1996,Taiwan,0,1,0,1,74
1996,Thailand,1,0,1,2,37
1996,Tonga,0,1,0,1,5
1996,Trinidad,2,0,0,2,12
1996,Tunisia,1,0,0,1,51
1996,Turkey,1,1,4,6,53
1996,UK,9,15,2,26,300
1996,USA,52,48,159,259,649
1996,Uganda,1,0,0,1,10
1996,Ukraine,19,5,10,34,232
1996,Uzbekistan,1,1,0,2,71
1996,Zambia,0,1,0,1,8
1998,Australia,1,0,0,1,24
1998,Austria,12,5,3,20,97
1998,Belarus,2,0,0,2,59
1998,Belgium,1,0,0,1,1
1998,Bulgaria,0,0,1,1,19
1998,Canada,7,28,14,49,147
1998,China,5,9,0,14,57
1998,Czech Republic,1,1,21,23,62
1998,Denmark,0,5,0,5,12
1998,Finland,49,7,2,58,86
1998,France,12,1,2,15,106
1998,Germany,10,12,22,44,126
1998,Italy,5,9,3,17,114
1998,Japan,4,1,8,13,156
1998,Kazakhstan,2,0,0,2,60
1998,Netherlands,2,4,5,11,22
1998,Norway,12,16,16,44,76
1998,Russia,6,32,14,52,122
1998,South Korea,2,4,6,12,37
1998,Sweden,5,2,0,7,101
1998,Switzerland,3,5,6,14,69
1998,UK,4,0,0,4,34
1998,USA,5,4,25,34,186
1998,Ukraine,0,1,0,1,56
2000,Algeria,3,1,1,5,47
2000,Argentina,3,17,0,20,143
2000,Armenia,1,0,0,1,25
2000,Australia,54,69,60,183,619
2000,Austria,0,1,3,4,92
2000,Azerbaijan,1,0,2,3,31
2000,Bahamas,5,0,6,11,25
2000,Barbados,1,0,0,1,18
2000,Belarus,11,8,3,22,139
2000,Belgium,4,3,0,7,68
2000,Brazil,36,12,0,48,200
2000,Bulgaria,2,6,5,13,91
2000,Cameroon,0,0,18,18,34
2000,Canada,23,4,4,31,294
2000,Chile,17,0,0,17,50
2000,China,17,23,39,79,304
2000,Colombia,0,0,1,1,44
2000,Costa Rica,2,0,0,2,7
2000,Croatia,9,0,1,10,88
2000,Cuba,12,35,18,65,233
2000,Czech Republic,4,3,2,9,119
2000,Denmark,4,3,18,25,97
2000,Estonia,2,0,1,3,33
2000,Ethiopia,3,1,4,8,26
2000,Finland,1,1,3,5,70
2000,France,14,30,22,66,337
2000,Georgia,6,0,0,6,36
2000,Germany,64,23,31,118,426
2000,Greece,8,6,4,18,141
2000,Hungary,4,24,25,53,178
2000,Iceland,1,0,0,1,18
2000,India,1,0,0,1,66
2000,Indonesia,2,4,2,8,47
2000,Iran,1,0,3,4,34
2000,Ireland,0,1,0,1,64
2000,Israel,1,0,0,1,39
2000,Italy,29,14,22,65,361
2000,Jamaica,3,20,0,23,48
2000,Japan,8,31,5,44,267
2000,Kazakhstan,0,4,3,7,130
2000,Kenya,2,3,2,7,56
2000,Kuwait,1,0,0,1,30
2000,Kyrgyzstan,1,0,0,1,48
2000,Latvia,1,1,1,3,45
2000,Lithuania,15,0,2,17,61
2000,Macedonia,1,0,0,1,10
2000,Mexico,3,2,1,6,78
2000,Moldova,1,1,0,2,34
2000,Morocco,4,1,0,5,55
2000,Mozambique,0,0,1,1,5
2000,Netherlands,23,29,27,79,232
2000,New Zealand,3,0,1,4,147
2000,Nigeria,0,2,6,8,85
2000,North Korea,3,1,0,4,31
2000,Norway,19,4,20,43,93
2000,Poland,7,10,7,24,187
2000,Portugal,2,0,0,2,62
2000,Qatar,1,0,0,1,17
2000,Romania,13,6,27,46,146
2000,Russia,54,67,66,187,436
2000,Saudi Arabia,1,1,0,2,18
2000,Serbia,13,1,11,25,109
2000,Slovakia,1,3,2,6,109
2000,Slovenia,0,0,3,3,74
2000,South Africa,3,2,0,5,127
2000,South Korea,35,26,12,73,283
2000,Spain,20,19,3,42,322
2000,Sri Lanka,0,1,0,1,18
2000,Sweden,8,20,4,32,151
2000,Switzerland,2,11,1,14,102
2000,Taiwan,4,1,0,5,55
2000,Thailand,2,0,1,3,52
2000,Trinidad,1,1,0,2,19
2000,Turkey,2,0,3,5,57
2000,UK,12,20,22,54,310
2000,USA,51,61,129,241,589
2000,Ukraine,12,20,3,35,230
2000,Uruguay,0,1,0,1,15
2000,Uzbekistan,2,1,1,4,70
2000,Vietnam,0,1,0,1,7
2002,Australia,0,0,2,2,25
2002,Austria,13,4,3,20,91
2002,Belarus,1,0,0,1,64
2002,Bulgaria,2,1,0,3,23
2002,Canada,15,7,52,74,151
2002,China,9,5,2,16,68
2002,Croatia,0,1,3,4,13
2002,Czech Republic,0,2,1,3,77
2002,Estonia,1,1,1,3,17
2002,Finland,1,5,7,13,98
2002,France,5,5,5,15,114
2002,Germany,12,23,26,61,157
2002,Italy,6,11,4,21,109
2002,Japan,1,1,0,2,104
2002,Netherlands,0,5,3,8,27
2002,Norway,7,11,23,41,78
2002,Poland,1,1,0,2,27
2002,Russia,27,5,6,38,152
2002,Slovenia,4,0,0,4,40
2002,South Korea,0,2,5,7,46
2002,Sweden,24,2,0,26,103
2002,Switzerland,14,7,3,24,110
2002,UK,1,0,5,6,49
2002,USA,15,58,11,84,204
2004,Argentina,21,0,28,49,154
2004,Australia,31,77,49,157,470
2004,Austria,1,4,3,8,74
2004,Azerbaijan,4,0,1,5,37
2004,Bahamas,1,0,1,2,22
2004,Belarus,8,5,2,15,152
2004,Belgium,2,0,1,3,50
2004,Brazil,3,19,18,40,244
2004,Bulgaria,14,1,2,17,96
2004,Cameroon,0,0,1,1,17
2004,Canada,4,10,3,17,262
2004,Chile,1,0,3,4,22
2004,China,15,29,52,96,416
2004,Colombia,2,0,0,2,55
2004,Croatia,3,3,15,21,81
2004,Cuba,22,8,32,62,152
2004,Czech Republic,6,6,1,13,142
2004,Denmark,9,1,19,29,92
2004,Dominican Republic,0,0,1,1,33
2004,Egypt,3,1,1,5,97
2004,Eritrea,1,0,0,1,4
2004,Estonia,2,1,0,3,42
2004,Ethiopia,2,3,2,7,26
2004,Finland,0,2,0,2,53
2004,France,22,10,21,53,311
2004,Georgia,0,2,2,4,32
2004,Germany,63,45,41,149,446
2004,Greece,5,18,8,31,430
2004,Hungary,4,12,24,40,211
2004,India,0,1,0,1,73
2004,Indonesia,3,1,1,5,38
2004,Iran,2,2,2,6,37
2004,Israel,1,0,1,2,36
2004,Italy,39,41,24,104,364
2004,Jamaica,6,1,6,13,48
2004,Japan,52,20,21,93,311
2004,Kazakhstan,3,4,1,8,115
2004,Kenya,2,4,1,7,46
2004,Latvia,0,4,0,4,32
2004,Lithuania,0,2,1,3,59
2004,Mexico,1,3,0,4,110
2004,Mongolia,1,0,0,1,20
2004,Morocco,0,1,2,3,55
2004,Netherlands,22,51,4,77,211
2004,New Zealand,0,2,4,6,148
2004,Nigeria,8,0,0,8,73
2004,North Korea,1,4,0,5,36
2004,Norway,2,0,5,7,52
2004,Paraguay,0,17,0,17,22
2004,Poland,6,2,4,12,196
2004,Portugal,1,2,0,3,81
2004,Romania,11,5,23,39,109
2004,Russia,95,46,48,189,447
2004,Serbia,0,13,0,13,86
2004,Slovakia,5,2,3,10,64
2004,Slovenia,3,2,0,5,79
2004,South Africa,3,3,4,10,106
2004,South Korea,10,28,14,52,265
2004,Spain,9,17,4,30,316
2004,Sweden,2,5,5,12,117
2004,Switzerland,4,2,1,7,98
2004,Syria,1,0,0,1,6
2004,Taiwan,3,4,2,9,88
2004,Thailand,4,1,3,8,42
2004,Trinidad,1,0,0,1,19
2004,Turkey,4,3,3,10,64
2004,UK,15,25,17,57,265
2004,USA,71,75,117,263,540
2004,Ukraine,31,8,8,47,241
2004,United Arab Emirates,0,0,1,1,4
2004,Uzbekistan,2,1,2,5,70
2004,Venezuela,2,0,0,2,48
2004,Zimbabwe,1,1,1,3,12
2006,Australia,1,0,1,2,40
2006,Austria,7,7,16,30,73
2006,Belarus,0,1,0,1,28
2006,Bulgaria,0,1,0,1,21
2006,Canada,11,28,30,69,191
2006,China,6,5,2,13,74
2006,Croatia,0,2,1,3,23
2006,Czech Republic,24,2,1,27,83
2006,Estonia,0,0,3,3,26
2006,Finland,7,34,0,41,91
2006,France,10,2,3,15,84
2006,Germany,6,25,23,54,155
2006,Italy,14,0,11,25,180
2006,Japan,0,0,1,1,110
2006,Latvia,1,0,0,1,57
2006,Netherlands,8,2,3,13,33
2006,Norway,12,9,2,23,68
2006,Poland,1,1,0,2,45
2006,Russia,13,12,16,41,176
2006,Slovakia,0,1,0,1,58
2006,South Korea,2,3,14,19,40
2006,Sweden,8,21,35,64,106
2006,Switzerland,9,7,5,21,125
2006,UK,0,1,0,1,39
2006,USA,32,11,9,52,204
2006,Ukraine,3,0,0,3,52
2008,Afghanistan,1,0,0,1,4
2008,Algeria,1,1,0,2,59
2008,Argentina,31,0,20,51,133
2008,Armenia,4,1,0,5,25
2008,Australia,76,42,31,149,433
2008,Austria,2,1,0,3,70
2008,Azerbaijan,4,1,1,6,44
2008,Bahamas,1,6,0,7,25
2008,Belarus,14,4,7,25,177
2008,Belgium,0,0,5,5,96
2008,Brazil,35,34,14,83,271
2008,Bulgaria,3,1,1,5,70
2008,Cameroon,0,0,1,1,32
2008,Canada,12,13,11,36,333
2008,Chile,0,1,0,1,26
2008,China,59,54,71,184,635
2008,Colombia,1,2,0,3,67
2008,Croatia,3,2,0,5,101
2008,Cuba,17,33,3,53,162
2008,Czech Republic,1,4,3,8,134
2008,Denmark,6,7,6,19,85
2008,Dominican Republic,0,1,1,2,25
2008,Ecuador,0,1,0,1,25
2008,Egypt,2,0,0,2,100
2008,Estonia,0,2,1,3,47
2008,Ethiopia,1,2,4,7,27
2008,Finland,2,2,1,5,58
2008,France,29,24,25,78,311
2008,Georgia,2,2,3,7,35
2008,Germany,40,17,42,99,425
2008,Greece,3,3,0,6,152
2008,Hungary,3,8,16,27,170
2008,Iceland,0,14,0,14,27
2008,India,2,0,1,3,53
2008,Indonesia,4,2,2,8,24
2008,Iran,1,0,1,2,54
2008,Ireland,2,1,0,3,54
2008,Israel,1,0,0,1,43
2008,Italy,21,14,8,43,335
2008,Jamaica,2,8,5,15,49
2008,Japan,12,16,23,51,333
2008,Kazakhstan,4,3,2,9,130
2008,Kenya,6,4,6,16,46
2008,Kyrgyzstan,2,1,0,3,20
2008,Latvia,1,1,1,3,48
2008,Lithuania,2,3,0,5,71
2008,Malaysia,0,1,0,1,32
2008,Mauritius,1,0,0,1,12
2008,Mexico,3,0,2,5,83
2008,Moldova,1,0,0,1,29
2008,Mongolia,0,2,2,4,28
2008,Morocco,1,1,0,2,47
2008,Netherlands,4,18,39,61,240
2008,New Zealand,9,2,4,15,181
2008,Nigeria,2,22,0,24,76
2008,North Korea,2,2,2,6,58
2008,Norway,1,5,16,22,84
2008,Panama,0,0,1,1,5
2008,Poland,2,9,7,18,258
2008,Portugal,0,1,1,2,77
2008,Romania,17,1,5,23,101
2008,Russia,48,33,41,122,455
2008,Samoa,0,1,0,1,6
2008,Serbia,14,1,0,15,88
2008,Slovakia,0,6,4,10,55
2008,Slovenia,2,2,1,5,61
2008,South Africa,0,1,0,1,135
2008,South Korea,26,12,41,79,266
2008,Spain,16,48,7,71,284
2008,Sudan,0,1,0,1,9
2008,Sweden,2,5,0,7,125
2008,Switzerland,7,1,3,11,83
2008,Taiwan,2,1,1,4,80
2008,Tajikistan,1,1,0,2,15
2008,Thailand,2,2,2,6,47
2008,Togo,1,0,0,1,4
2008,Trinidad,0,1,5,6,28
2008,Tunisia,0,0,1,1,26
2008,Turkey,3,1,1,5,67
2008,UK,31,25,31,87,309
2008,USA,82,110,127,319,588
2008,Ukraine,12,4,10,26,245
2008,Uzbekistan,3,1,0,4,56
2008,Venezuela,1,0,0,1,108
2008,Vietnam,0,1,0,1,13
2008,Zimbabwe,0,3,1,4,13
2010,Argentina,0,3,1,4,14
2010,Armenia,0,1,0,1,7
2010,Australia,5,8,7,20,53
2010,Austria,6,9,12,27,78
2010,Azerbaijan,0,0,1,1,3
2010,Bahamas,0,1,1,2,3
2010,Belarus,1,3,1,5,53
2010,Belgium,1,1,1,3,11
2010,Bosnia and Herzegovina,1,0,0,1,5
2010,Brazil,1,2,0,3,13
2010,Bulgaria,1,0,1,2,21
2010,Canada,13,16,70,99,208
2010,China,7,8,29,44,99
2010,Colombia,0,1,1,2,6
2010,Croatia,3,2,0,5,23
2010,Cuba,0,0,5,5,7
2010,Czech Republic,9,0,2,11,95
2010,Denmark,0,1,0,1,19
2010,Dominican Republic,0,0,2,2,1
2010,Egypt,1,1,0,2,3
2010,Eritrea,0,0,1,1,1
2010,Estonia,0,1,0,1,30
2010,Ethiopia,0,0,1,1,4
2010,Finland,47,1,0,48,97
2010,France,14,8,6,28,115
2010,Germany,18,25,16,59,159
2010,Hungary,3,2,5,10,26
2010,India,1,1,0,2,7
2010,Indonesia,1,0,0,1,2
2010,Israel,0,2,1,3,6
2010,Italy,7,4,3,14,120
2010,Japan,3,5,5,13,100
2010,Kazakhstan,0,3,1,4,43
2010,Kenya,1,0,0,1,1
2010,Latvia,0,3,0,3,55
2010,Lithuania,0,0,2,2,11
2010,Malaysia,0,2,0,2,2
2010,Mexico,1,0,0,1,6
2010,Morocco,1,0,0,1,2
2010,Netherlands,7,1,5,13,36
2010,New Zealand,1,1,0,2,20
2010,Nigeria,1,1,0,2,2
2010,North Korea,1,0,0,1,4
2010,Norway,10,14,16,40,98
2010,Pakistan,0,1,0,1,2
2010,Poland,5,3,1,9,49
2010,Portugal,1,0,0,1,3
2010,Qatar,0,1,0,1,2
2010,Romania,1,4,1,6,36
2010,Russia,16,9,16,41,189
2010,Serbia,1,1,0,2,13
2010,Slovakia,1,1,1,3,71
2010,Slovenia,1,2,0,3,49
2010,South Africa,3,3,1,7,5
2010,South Korea,3,12,8,23,52
2010,Spain,3,3,0,6,24
2010,Sweden,5,3,13,21,107
2010,Switzerland,7,0,7,14,144
2010,Taiwan,0,1,0,1,3
2010,Thailand,0,2,2,4,8
2010,Turkey,0,1,0,1,6
2010,Turkmenistan,1,0,0,1,2
2010,UK,2,1,3,6,58
2010,USA,25,64,12,101,220
2010,Ukraine,6,5,8,19,59
2010,Venezuela,1,1,0,2,2
2010,Vietnam,1,0,1,2,3
2012,Afghanistan,1,0,0,1,6
2012,Algeria,0,0,1,1,38
2012,Andorra,1,0,0,1,7
2012,Argentina,3,15,1,19,137
2012,Armenia,1,1,0,2,24
2012,Australia,59,35,19,113,410
2012,Austria,3,1,5,9,78
2012,Azerbaijan,5,2,2,9,52
2012,Bahamas,0,0,4,4,21
2012,Bahrain,0,0,1,1,12
2012,Belarus,6,12,3,21,160
2012,Belgium,2,1,0,3,113
2012,Botswana,0,1,0,1,4
2012,Brazil,11,34,13,58,249
2012,Bulgaria,1,2,0,3,63
2012,Cameroon,1,0,0,1,32
2012,Canada,33,23,2,58,282
2012,China,32,46,57,135,421
2012,Colombia,5,3,1,9,101
2012,Croatia,16,4,15,35,110
2012,Cuba,7,3,5,15,109
2012,Cyprus,0,1,0,1,14
2012,Czech Republic,6,5,5,16,140
2012,Denmark,8,5,3,16,114
2012,Dominican Republic,0,1,1,2,33
2012,Egypt,1,3,0,4,110
2012,Estonia,1,3,0,4,36
2012,Ethiopia,3,2,3,8,33
2012,Finland,3,4,0,7,59
2012,France,24,31,31,86,328
2012,Gabon,0,1,0,1,21
2012,Georgia,3,2,1,6,33
2012,Germany,21,30,52,103,394
2012,Greece,3,0,0,3,103
2012,Grenada,0,0,1,1,9
2012,Guatemala,0,1,0,1,19
2012,Hungary,6,8,12,26,153
2012,India,4,2,0,6,82
2012,Indonesia,1,2,0,3,22
2012,Iran,1,5,7,13,53
2012,Ireland,4,1,1,6,65
2012,Italy,30,21,16,67,283
2012,Jamaica,4,14,8,26,46
2012,Japan,38,47,8,93,296
2012,Kazakhstan,8,2,3,13,118
2012,Kenya,7,4,2,13,47
2012,Kuwait,1,0,0,1,10
2012,Latvia,3,0,1,4,48
2012,Lithuania,3,0,2,5,62
2012,Malaysia,1,1,0,2,29
2012,Mexico,4,5,16,25,99
2012,Monaco,1,0,0,1,7
2012,Mongolia,3,2,0,5,29
2012,Montenegro,0,14,0,14,33
2012,Morocco,1,0,1,2,65
2012,Netherlands,20,29,21,70,176
2012,New Zealand,15,3,9,27,186
2012,North Korea,3,0,4,7,52
2012,Norway,1,2,15,18,63
2012,Poland,8,2,3,13,210
2012,Portugal,0,2,0,2,77
2012,Puerto Rico,1,1,0,2,25
2012,Qatar,1,1,0,2,12
2012,Romania,5,7,2,14,110
2012,Russia,47,32,46,125,434
2012,Saudi Arabia,4,0,0,4,18
2012,Serbia,14,1,1,16,111
2012,Slovakia,4,1,1,6,52
2012,Slovenia,4,5,1,10,73
2012,South Africa,1,1,7,9,126
2012,South Korea,32,15,21,68,258
2012,Spain,27,33,6,66,278
2012,Sweden,3,17,5,25,141
2012,Switzerland,1,2,3,6,103
2012,Taiwan,1,0,0,1,43
2012,Tajikistan,1,0,0,1,16
2012,Thailand,2,2,0,4,37
2012,Trinidad,5,4,1,10,26
2012,Tunisia,1,0,2,3,83
2012,Turkey,1,1,1,3,113
2012,UK,47,33,48,128,536
2012,USA,50,58,150,258,543
2012,Uganda,0,0,1,1,15
2012,Ukraine,16,7,8,31,238
2012,Uzbekistan,3,0,0,3,53
2012,Venezuela,0,0,1,1,68
2012,Vietnam,1,0,0,1,18
2014,Argentina,0,1,0,1,9
2014,Armenia,0,1,1,2,8
2014,Australia,11,2,1,14,64
2014,Austria,11,12,4,27,127
2014,Azerbaijan,1,1,1,3,7
2014,Bahamas,1,0,0,1,2
2014,Bahrain,1,1,0,2,1
2014,Belarus,1,0,5,6,26
2014,Belgium,1,0,0,1,9
2014,Botswana,0,2,0,2,4
2014,Brazil,1,7,2,10,21
2014,Canada,7,25,59,91,224
2014,China,8,10,29,47,74
2014,Colombia,1,0,0,1,4
2014,Croatia,0,1,0,1,11
2014,Cuba,1,0,0,1,3
2014,Czech Republic,8,8,2,18,90
2014,Djibouti,1,0,0,1,2
2014,Egypt,0,2,3,5,9
2014,El Salvador,0,1,0,1,2
2014,Finland,24,7,2,33,99
2014,France,10,4,5,19,108
2014,Germany,12,13,15,40,153
2014,Greece,0,1,0,1,10
2014,Hungary,3,1,5,9,24
2014,Iran,0,0,1,1,7
2014,Italy,14,4,2,20,115
2014,Jamaica,0,0,1,1,4
2014,Japan,7,6,2,15,116
2014,Kazakhstan,1,0,1,2,53
2014,Latvia,10,1,4,15,59
2014,Lithuania,0,0,2,2,10
2014,Mexico,2,1,1,4,5
2014,Moldova,0,0,1,1,6
2014,Netherlands,11,8,13,32,43
2014,New Zealand,0,0,1,1,17
2014,Norway,11,9,18,38,111
2014,Poland,3,4,5,12,61
2014,Russia,16,27,36,79,223
2014,Slovakia,0,1,1,2,64
2014,Slovenia,5,2,3,10,63
2014,South Korea,3,5,9,17,75
2014,Spain,2,0,0,2,22
2014,Sweden,12,32,8,52,105
2014,Switzerland,20,2,10,32,156
2014,Taiwan,0,1,1,2,5
2014,Thailand,0,0,1,1,5
2014,Trinidad,1,1,0,2,1
2014,UK,13,5,2,20,57
2014,USA,20,36,11,67,230
2014,Ukraine,2,3,7,12,49
2014,Uzbekistan,0,0,1,1,5
2014,Venezuela,2,2,0,4,4
2014,Vietnam,0,0,1,1,1
2016,Algeria,0,2,0,2,64
2016,Argentina,0,1,21,22,216
2016,Armenia,0,3,1,4,32
2016,Australia,25,35,23,83,424
2016,Austria,4,0,0,4,74
2016,Azerbaijan,10,7,1,18,56
2016,Bahamas,5,0,1,6,29
2016,Bahrain,0,1,1,2,33
2016,Belarus,7,4,1,12,121
2016,Belgium,2,17,2,21,107
2016,Brazil,6,7,36,49,462
2016,Bulgaria,6,1,0,7,52
2016,Burundi,0,1,0,1,9
2016,Canada,62,4,5,71,315
2016,China,37,34,47,118,432
2016,Colombia,3,2,3,8,145
2016,Croatia,2,15,7,24,87
2016,Cuba,4,2,5,11,117
2016,Czech Republic,13,6,1,20,109
2016,Denmark,16,10,15,41,119
2016,Dominican Republic,1,0,0,1,26
2016,Egypt,3,0,0,3,121
2016,Estonia,4,0,0,4,48
2016,Ethiopia,5,2,1,8,38
2016,Fiji,0,0,13,13,53
2016,Finland,2,0,0,2,56
2016,France,21,56,20,97,395
2016,Georgia,4,1,2,7,40
2016,Germany,71,43,50,164,425
2016,Greece,3,1,3,7,94
2016,Grenada,0,1,0,1,7
2016,Hungary,8,5,12,25,156
2016,India,1,1,0,2,113
2016,Individual Olympic Athletes,1,0,1,2,9
2016,Indonesia,0,2,2,4,28
2016,Iran,4,1,3,8,63
2016,Ireland,0,3,0,3,76
2016,Israel,2,0,0,2,48
2016,Italy,24,40,8,72,311
2016,Ivory Coast,1,0,1,2,12
2016,Jamaica,2,17,11,30,56
2016,Japan,35,14,17,66,338
2016,Jordan,0,0,1,1,8
2016,Kazakhstan,11,5,2,18,104
2016,Kenya,1,6,6,13,80
2016,Kosovo,0,0,1,1,8
2016,Latvia,1,2,1,4,36
2016,Lithuania,5,2,0,7,67
2016,Malaysia,1,7,0,8,32
2016,Mexico,2,3,0,5,123
2016,Mongolia,1,1,0,2,43
2016,Morocco,1,0,0,1,48
2016,Netherlands,13,25,9,47,237
2016,New Zealand,6,26,6,38,201
2016,Niger,0,1,0,1,6
2016,Nigeria,18,0,0,18,71
2016,North Korea,2,3,2,7,31
2016,Norway,21,0,0,21,63
2016,Philippines,0,1,0,1,13
2016,Poland,10,3,3,16,236
2016,Portugal,1,0,0,1,90
2016,Puerto Rico,0,0,1,1,40
2016,Qatar,0,1,0,1,38
2016,Romania,10,2,4,16,98
2016,Russia,36,32,55,123,293
2016,Serbia,13,26,14,53,102
2016,Slovakia,0,5,3,8,52
2016,Slovenia,3,2,4,9,68
2016,South Africa,14,7,2,23,136
2016,South Korea,12,5,22,39,217
2016,Spain,17,19,9,45,307
2016,Sweden,3,22,3,28,150
2016,Switzerland,4,4,7,15,106
2016,Taiwan,3,0,0,3,53
2016,Tajikistan,0,0,1,1,7
2016,Thailand,2,2,2,6,54
2016,Trinidad,1,0,0,1,28
2016,Tunisia,3,0,0,3,61
2016,Turkey,4,3,1,8,100
2016,UK,26,55,64,145,360
2016,USA,71,56,143,270,562
2016,Ukraine,5,8,2,15,206
2016,United Arab Emirates,1,0,0,1,13
2016,Uzbekistan,7,2,4,13,70
2016,Venezuela,1,2,0,3,85
2016,Vietnam,0,1,1,2,22
2018,Australia,1,2,0,3,50
2018,Austria,12,9,5,26,102
2018,Belarus,0,1,5,6,32
2018,Belgium,0,1,0,1,22
2018,Canada,38,33,20,91,222
2018,China,2,11,1,14,82
2018,Czech Republic,4,2,4,10,92
2018,Finland,24,1,1,26,96
2018,France,13,5,8,26,102
2018,Germany,11,40,27,78,146
2018,Hungary,0,0,7,7,19
2018,Italy,7,5,3,15,115
2018,Japan,7,5,7,19,120
2018,Kazakhstan,1,0,0,1,44
2018,Kyrgyzstan,0,1,0,1,3
2018,Latvia,2,0,0,2,34
2018,Liechtenstein,1,0,0,1,3
2018,Netherlands,13,9,8,30,32
2018,New Zealand,2,0,0,2,20
2018,Norway,18,23,27,68,99
2018,Poland,4,0,1,5,61
2018,Russia,12,18,25,55,167
2018,Serbia,0,1,0,1,5
2018,Slovakia,0,2,1,3,54
2018,Slovenia,1,1,0,2,70
2018,South Korea,4,17,9,30,121
2018,Spain,2,0,0,2,13
2018,Sweden,1,17,12,30,107
2018,Switzerland,8,7,10,25,161
2018,UK,4,0,1,5,57
2018,USA,18,9,34,61,230
2018,Ukraine,0,0,1,1,33
2020,Argentina,20,14,0,34,188
2020,Armenia,2,2,0,4,17
2020,Australia,67,25,33,125,501
2020,Austria,12,7,12,31,128
2020,Azerbaijan,4,3,0,7,43
2020,Bahamas,0,0,2,2,14
2020,Bahrain,0,1,0,1,33
2020,Belarus,4,6,1,11,116
2020,Belgium,5,1,20,26,129
2020,Bermuda,0,0,1,1,2
2020,Botswana,4,0,0,4,12
2020,Brazil,8,17,29,54,310
2020,Bulgaria,3,1,7,11,55
2020,Burkina Faso,1,0,0,1,7
2020,Canada,53,18,36,107,445
2020,China,48,51,58,157,486
2020,Colombia,1,5,0,6,67
2020,Croatia,3,4,3,10,66
2020,Cuba,5,3,8,16,67
2020,Czech Republic,7,5,8,20,184
2020,Denmark,6,22,4,32,128
2020,Dominican Republic,25,7,0,32,64
2020,Ecuador,0,1,2,3,43
2020,Egypt,3,0,1,4,127
2020,Estonia,2,0,7,9,57
2020,Ethiopia,2,1,1,4,31
2020,Fiji,13,0,13,26,32
2020,Finland,3,5,3,11,97
2020,France,43,53,69,165,441
2020,Georgia,3,5,4,12,41
2020,Germany,45,37,26,108,489
2020,Ghana,1,0,0,1,14
2020,Greece,1,13,2,16,88
2020,Grenada,1,0,0,1,4
2020,Hungary,37,7,10,54,181
2020,India,20,2,1,23,116
2020,Indonesia,2,1,2,5,25
2020,Iran,1,2,3,6,69
2020,Ireland,4,0,3,7,116
2020,Israel,12,1,0,13,85
2020,Italy,40,21,24,85,422
2020,Ivory Coast,1,0,0,1,31
2020,Jamaica,8,1,9,18,57
2020,Japan,22,54,94,170,660
2020,Jordan,1,1,0,2,13
2020,Kazakhstan,8,0,0,8,118
2020,Kenya,2,4,4,10,84
2020,Kosovo,0,0,2,2,11
2020,Kuwait,1,0,0,1,9
2020,Kyrgyzstan,1,2,0,3,18
2020,Latvia,7,3,4,14,57
2020,Liechtenstein,1,0,0,1,10
2020,Lithuania,1,1,0,2,54
2020,Luxembourg,0,0,1,1,16
2020,Macedonia,0,1,0,1,13
2020,Malaysia,2,1,0,3,30
2020,Mexico,24,0,1,25,156
2020,Moldova,1,0,0,1,23
2020,Mongolia,3,1,0,4,48
2020,Morocco,0,0,1,1,42
2020,Namibia,0,1,0,1,10
2020,Netherlands,18,25,34,77,289
2020,New Zealand,11,27,29,67,228
2020,Nigeria,1,1,0,2,54
2020,Norway,20,6,17,43,140
2020,Philippines,1,2,1,4,20
2020,Poland,9,17,11,37,240
2020,Portugal,2,1,0,3,91
2020,Puerto Rico,0,0,1,1,35
2020,Qatar,2,0,2,4,17
2020,Romania,1,6,4,11,131
2020,Russia,41,99,72,212,423
2020,San Marino,2,2,0,4,4
2020,Saudi Arabia,0,1,0,1,27
2020,Serbia,18,2,15,35,86
2020,Slovakia,22,5,1,28,88
2020,Slovenia,1,4,4,9,89
2020,South Africa,0,2,1,3,168
2020,South Korea,18,11,21,50,267
2020,Spain,28,45,7,80,344
2020,Sweden,8,47,11,66,180
2020,Switzerland,15,13,20,48,219
2020,Syria,1,0,0,1,6
2020,Taiwan,5,8,2,15,71
2020,Thailand,1,0,1,2,45
2020,Turkey,10,2,2,14,115
2020,Turkmenistan,0,1,0,1,10
2020,UK,56,38,39,133,406
2020,USA,78,128,110,316,707
2020,Uganda,1,1,2,4,23
2020,Ukraine,22,7,2,31,179
2020,Uzbekistan,2,0,2,4,62
2020,Venezuela,0,3,1,4,42
2022,Australia,1,2,1,4,41
2022,Austria,5,10,15,30,97
2022,Belarus,0,2,0,2,23
2022,Belgium,1,0,1,2,16
2022,Canada,25,8,32,65,205
2022,China,6,6,14,26,165
2022,Czech Republic,1,0,1,2,105
2022,Estonia,1,0,0,1,25
2022,Finland,24,3,25,52,83
2022,France,5,12,6,23,74
2022,Germany,12,25,20,57,139
2022,Hungary,6,0,1,7,14
2022,Italy,10,12,2,24,107
2022,Japan,19,12,3,34,117
2022,Latvia,4,0,0,4,53
2022,Netherlands,7,5,11,23,38
2022,New Zealand,0,1,2,3,14
2022,Norway,17,12,26,55,73
2022,Poland,1,0,0,1,54
2022,Russia,22,44,16,82,197
2022,Slovakia,23,0,1,24,45
2022,Slovenia,2,6,5,13,37
2022,South Korea,2,12,2,16,62
2022,Spain,0,1,0,1,14
2022,Sweden,8,1,12,21,51
2022,Switzerland,6,2,7,15,152
2022,UK,0,4,4,8,47
2022,USA,8,29,9,46,102
2022,Ukraine,0,1,0,1,25
